42
22
32 34 34 34 34 34 33 0 0 0 34 33 34 0 0 0 0 0 0 0 0 0 0 0 0 0 0 0 0 0 0 0 34 33 39 34 34 34 34 34 31 31 
32 0 0 0 0 0 35 0 0 0 0 35 0 0 0 0 0 0 0 0 0 0 0 32 32 32 0 0 0 0 0 0 0 35 0 0 0 0 0 0 31 31 
32 31 0 0 0 0 35 0 0 0 0 35 0 0 0 0 0 0 0 0 0 0 0 0 0 0 0 0 0 0 0 0 0 35 0 30 0 0 0 0 31 31 
32 0 0 0 0 0 35 0 0 0 0 0 0 0 0 0 0 0 38 0 0 0 0 0 0 0 0 0 0 0 0 0 0 35 0 30 0 0 0 0 31 31 
32 0 0 0 32 32 32 32 0 0 0 0 0 0 0 0 38 0 37 0 32 32 32 32 32 32 32 32 32 32 0 0 0 35 0 30 0 0 0 0 31 31 
32 0 0 0 0 0 0 0 0 0 0 0 0 0 38 0 37 0 37 0 32 0 37 0 32 0 32 0 0 0 0 0 0 35 0 30 0 0 0 0 31 31 
32 0 0 0 0 0 0 0 0 0 0 0 0 0 37 0 37 0 37 0 32 0 37 0 32 32 32 0 0 0 0 0 0 35 0 30 0 0 0 0 31 31 
32 30 30 30 30 30 30 30 30 30 30 30 30 32 37 0 37 0 36 0 32 0 36 0 32 0 32 0 0 0 0 0 32 35 30 30 0 0 0 0 31 31 
31 0 0 0 0 0 0 0 0 0 0 0 0 0 37 0 37 0 32 0 32 32 32 32 0 0 0 32 32 32 0 0 0 0 0 0 0 0 0 0 31 31 
31 0 0 0 0 0 0 0 0 0 0 0 0 0 37 0 37 0 32 0 0 0 0 0 0 0 0 0 0 0 0 0 0 0 0 0 0 0 0 0 31 31 
31 0 0 0 0 0 0 0 0 0 31 31 31 0 37 0 37 0 32 0 0 0 0 0 0 0 0 0 0 0 0 0 0 0 0 0 0 0 0 0 31 31 
31 0 0 0 0 0 0 0 0 0 31 0 0 0 37 0 37 0 32 0 0 0 0 0 32 32 32 32 32 32 32 32 32 32 32 0 0 0 0 0 31 31 
31 0 0 0 0 0 0 0 0 0 31 31 0 0 36 0 37 0 32 0 0 0 0 0 0 32 0 0 0 0 0 0 0 0 0 0 0 0 0 32 31 31 
31 0 0 0 30 30 30 0 0 0 31 28 0 0 0 0 37 0 32 0 0 0 0 0 0 32 32 32 0 0 0 0 0 0 0 0 0 0 0 0 31 31 
31 0 0 0 30 0 0 0 0 0 31 31 31 0 0 0 36 0 32 32 32 0 0 0 0 0 0 32 0 0 32 32 32 32 0 0 32 0 0 0 31 31 
31 32 0 0 30 30 30 0 0 0 0 0 0 0 0 0 0 0 32 0 0 0 0 0 0 0 0 32 0 32 32 0 0 32 0 0 0 0 0 0 31 31 
31 0 0 0 0 0 30 0 0 0 0 0 0 0 0 0 0 0 32 0 0 0 0 32 32 32 32 32 0 0 32 32 32 32 0 0 0 0 0 32 31 31 
31 0 0 0 30 30 30 0 0 0 0 32 32 0 0 0 0 0 32 32 0 0 0 32 0 0 0 32 0 0 32 32 0 0 0 0 0 0 0 32 31 31 
31 32 0 0 0 0 0 0 0 32 32 0 0 0 0 0 0 0 32 32 0 0 32 32 0 32 32 32 32 0 32 0 32 0 0 0 0 0 32 32 31 31 
31 0 0 0 0 0 0 0 0 0 0 0 0 0 0 0 0 0 32 32 0 0 32 32 0 32 32 32 0 0 32 0 0 32 0 0 0 0 0 32 31 31 
31 0 0 0 0 0 0 0 0 0 0 0 0 0 0 0 0 0 32 32 32 0 0 32 0 0 0 32 0 0 39 39 39 39 0 0 0 0 0 32 31 31 
31 31 31 31 31 31 31 31 31 31 0 0 0 0 0 0 0 0 32 32 32 32 32 32 32 32 32 32 30 30 30 30 30 30 30 30 30 30 30 30 31 31 
